111111111111111111-
001000000111111111-
101011110111001111-
100011110111011111-
111111110111011111-
110000000111011111-
110111111111011111-
110111111111011111-
110000000000011111-
111111111111111111